11111111111111111
10000000000001001
10000000000001101
100E0100000000001
10000100000000001
11111100000000001
10000000000000001
1000000000P000001
10001100000000001
10001100000100001
10000000000100001
10000000000100001
10001000011000001
10010101110011101
11111111111111111
