11111111111111111
10000000000001001
10000000000001101
100E010C000000001
1000010C000000001
11111100000000001
1000000C000000001
100000R000P000001
10001100000C00001
10001100000100001
10000000000100001
100000000001C0001
10001000011000C01
10010101110011101
11111111111111111
